"filename", "language", "Python", "pip requirements", "Shell Script", "Markdown", "Ini", "comment", "blank", "total"
"/Users/minhtranquang/Documents/entobel_proj/SFM_BackEnd/README.md", "Markdown", 0, 0, 0, 86, 0, 0, 41, 127
"/Users/minhtranquang/Documents/entobel_proj/SFM_BackEnd/app/__init__.py", "Python", 0, 0, 0, 0, 0, 0, 1, 1
"/Users/minhtranquang/Documents/entobel_proj/SFM_BackEnd/app/alembic.ini", "Ini", 0, 0, 0, 0, 95, 0, 25, 120
"/Users/minhtranquang/Documents/entobel_proj/SFM_BackEnd/app/alembic/env.py", "Python", 33, 0, 0, 0, 0, 29, 16, 78
"/Users/minhtranquang/Documents/entobel_proj/SFM_BackEnd/app/application/dto/antioxidant_type_dto.py", "Python", 8, 0, 0, 0, 0, 0, 3, 11
"/Users/minhtranquang/Documents/entobel_proj/SFM_BackEnd/app/application/dto/auth_dto.py", "Python", 6, 0, 0, 0, 0, 0, 4, 10
"/Users/minhtranquang/Documents/entobel_proj/SFM_BackEnd/app/application/dto/dd_dto.py", "Python", 29, 0, 0, 0, 0, 0, 4, 33
"/Users/minhtranquang/Documents/entobel_proj/SFM_BackEnd/app/application/dto/department_dto.py", "Python", 18, 0, 0, 0, 0, 0, 7, 25
"/Users/minhtranquang/Documents/entobel_proj/SFM_BackEnd/app/application/dto/department_factory_dto.py", "Python", 10, 0, 0, 0, 0, 0, 4, 14
"/Users/minhtranquang/Documents/entobel_proj/SFM_BackEnd/app/application/dto/department_factory_role_dto.py", "Python", 12, 0, 0, 0, 0, 0, 4, 16
"/Users/minhtranquang/Documents/entobel_proj/SFM_BackEnd/app/application/dto/diet_dto.py", "Python", 11, 0, 0, 0, 0, 0, 3, 14
"/Users/minhtranquang/Documents/entobel_proj/SFM_BackEnd/app/application/dto/dried_larvae_discharge_type_dto.py", "Python", 9, 0, 0, 0, 0, 0, 4, 13
"/Users/minhtranquang/Documents/entobel_proj/SFM_BackEnd/app/application/dto/dryer_machine_type_dto.py", "Python", 11, 0, 0, 0, 0, 0, 4, 15
"/Users/minhtranquang/Documents/entobel_proj/SFM_BackEnd/app/application/dto/factory_dto.py", "Python", 13, 0, 0, 0, 0, 0, 3, 16
"/Users/minhtranquang/Documents/entobel_proj/SFM_BackEnd/app/application/dto/grinding_dto.py", "Python", 20, 0, 0, 0, 0, 0, 5, 25
"/Users/minhtranquang/Documents/entobel_proj/SFM_BackEnd/app/application/dto/growing_dto.py", "Python", 45, 0, 0, 0, 0, 0, 8, 53
"/Users/minhtranquang/Documents/entobel_proj/SFM_BackEnd/app/application/dto/growing_zone_level_dto.py", "Python", 19, 0, 0, 0, 0, 0, 6, 25
"/Users/minhtranquang/Documents/entobel_proj/SFM_BackEnd/app/application/dto/harvesting_dto.py", "Python", 19, 0, 0, 0, 0, 1, 4, 24
"/Users/minhtranquang/Documents/entobel_proj/SFM_BackEnd/app/application/dto/history_dto.py", "Python", 9, 0, 0, 0, 0, 0, 3, 12
"/Users/minhtranquang/Documents/entobel_proj/SFM_BackEnd/app/application/dto/level_dto.py", "Python", 10, 0, 0, 0, 0, 0, 3, 13
"/Users/minhtranquang/Documents/entobel_proj/SFM_BackEnd/app/application/dto/operation_type_dto.py", "Python", 13, 0, 0, 0, 0, 0, 4, 17
"/Users/minhtranquang/Documents/entobel_proj/SFM_BackEnd/app/application/dto/packing_type_dto.py", "Python", 13, 0, 0, 0, 0, 0, 4, 17
"/Users/minhtranquang/Documents/entobel_proj/SFM_BackEnd/app/application/dto/product_type_dto.py", "Python", 12, 0, 0, 0, 0, 0, 4, 16
"/Users/minhtranquang/Documents/entobel_proj/SFM_BackEnd/app/application/dto/role_dto.py", "Python", 10, 0, 0, 0, 0, 0, 5, 15
"/Users/minhtranquang/Documents/entobel_proj/SFM_BackEnd/app/application/dto/shift_dto.py", "Python", 12, 0, 0, 0, 0, 0, 4, 16
"/Users/minhtranquang/Documents/entobel_proj/SFM_BackEnd/app/application/dto/unit_dto.py", "Python", 12, 0, 0, 0, 0, 0, 4, 16
"/Users/minhtranquang/Documents/entobel_proj/SFM_BackEnd/app/application/dto/user_dto.py", "Python", 19, 0, 0, 0, 0, 0, 5, 24
"/Users/minhtranquang/Documents/entobel_proj/SFM_BackEnd/app/application/dto/vfbd_dto.py", "Python", 26, 0, 0, 0, 0, 0, 4, 30
"/Users/minhtranquang/Documents/entobel_proj/SFM_BackEnd/app/application/dto/zone_dto.py", "Python", 23, 0, 0, 0, 0, 0, 6, 29
"/Users/minhtranquang/Documents/entobel_proj/SFM_BackEnd/app/application/dto/zone_level_dto.py", "Python", 14, 0, 0, 0, 0, 0, 4, 18
"/Users/minhtranquang/Documents/entobel_proj/SFM_BackEnd/app/application/interfaces/use_cases/auth/login_uc.py", "Python", 6, 0, 0, 0, 0, 0, 4, 10
"/Users/minhtranquang/Documents/entobel_proj/SFM_BackEnd/app/application/interfaces/use_cases/dd/create_dd_report_uc.py", "Python", 5, 0, 0, 0, 0, 0, 4, 9
"/Users/minhtranquang/Documents/entobel_proj/SFM_BackEnd/app/application/interfaces/use_cases/department/create_department_factory_role_uc.py", "Python", 8, 0, 0, 0, 0, 0, 4, 12
"/Users/minhtranquang/Documents/entobel_proj/SFM_BackEnd/app/application/interfaces/use_cases/department/create_department_factory_uc.py", "Python", 8, 0, 0, 0, 0, 0, 5, 13
"/Users/minhtranquang/Documents/entobel_proj/SFM_BackEnd/app/application/interfaces/use_cases/department/create_department_uc.py", "Python", 5, 0, 0, 0, 0, 0, 4, 9
"/Users/minhtranquang/Documents/entobel_proj/SFM_BackEnd/app/application/interfaces/use_cases/department/list_department_factory_role_uc.py", "Python", 20, 0, 0, 0, 0, 0, 4, 24
"/Users/minhtranquang/Documents/entobel_proj/SFM_BackEnd/app/application/interfaces/use_cases/department/list_department_factory_uc.py", "Python", 13, 0, 0, 0, 0, 0, 3, 16
"/Users/minhtranquang/Documents/entobel_proj/SFM_BackEnd/app/application/interfaces/use_cases/department/list_department_uc.py", "Python", 8, 0, 0, 0, 0, 0, 4, 12
"/Users/minhtranquang/Documents/entobel_proj/SFM_BackEnd/app/application/interfaces/use_cases/department/update_department_uc.py", "Python", 5, 0, 0, 0, 0, 0, 4, 9
"/Users/minhtranquang/Documents/entobel_proj/SFM_BackEnd/app/application/interfaces/use_cases/department/update_status_department_factory_role_uc.py", "Python", 8, 0, 0, 0, 0, 0, 4, 12
"/Users/minhtranquang/Documents/entobel_proj/SFM_BackEnd/app/application/interfaces/use_cases/department/update_status_department_factory_uc.py", "Python", 5, 0, 0, 0, 0, 0, 4, 9
"/Users/minhtranquang/Documents/entobel_proj/SFM_BackEnd/app/application/interfaces/use_cases/department/update_status_department_uc.py", "Python", 4, 0, 0, 0, 0, 0, 3, 7
"/Users/minhtranquang/Documents/entobel_proj/SFM_BackEnd/app/application/interfaces/use_cases/diet/create_diet_uc.py", "Python", 5, 0, 0, 0, 0, 0, 4, 9
"/Users/minhtranquang/Documents/entobel_proj/SFM_BackEnd/app/application/interfaces/use_cases/diet/list_diet_uc.py", "Python", 17, 0, 0, 0, 0, 0, 4, 21
"/Users/minhtranquang/Documents/entobel_proj/SFM_BackEnd/app/application/interfaces/use_cases/diet/update_diet_uc.py", "Python", 5, 0, 0, 0, 0, 0, 4, 9
"/Users/minhtranquang/Documents/entobel_proj/SFM_BackEnd/app/application/interfaces/use_cases/diet/update_status_diet_uc.py", "Python", 5, 0, 0, 0, 0, 0, 4, 9
"/Users/minhtranquang/Documents/entobel_proj/SFM_BackEnd/app/application/interfaces/use_cases/factory/create_factory_uc.py", "Python", 5, 0, 0, 0, 0, 0, 4, 9
"/Users/minhtranquang/Documents/entobel_proj/SFM_BackEnd/app/application/interfaces/use_cases/factory/list_factory_uc.py", "Python", 13, 0, 0, 0, 0, 0, 4, 17
"/Users/minhtranquang/Documents/entobel_proj/SFM_BackEnd/app/application/interfaces/use_cases/factory/update_factory_uc.py", "Python", 5, 0, 0, 0, 0, 0, 4, 9
"/Users/minhtranquang/Documents/entobel_proj/SFM_BackEnd/app/application/interfaces/use_cases/factory/update_status_factory_uc.py", "Python", 4, 0, 0, 0, 0, 0, 3, 7
"/Users/minhtranquang/Documents/entobel_proj/SFM_BackEnd/app/application/interfaces/use_cases/grinding/create_grinding_uc.py", "Python", 9, 0, 0, 0, 0, 0, 4, 13
"/Users/minhtranquang/Documents/entobel_proj/SFM_BackEnd/app/application/interfaces/use_cases/growing/create_growing_report_uc.py", "Python", 11, 0, 0, 0, 0, 0, 4, 15
"/Users/minhtranquang/Documents/entobel_proj/SFM_BackEnd/app/application/interfaces/use_cases/growing/list_growing_report_uc.py", "Python", 29, 0, 0, 0, 0, 0, 6, 35
"/Users/minhtranquang/Documents/entobel_proj/SFM_BackEnd/app/application/interfaces/use_cases/growing/update_growing_report_uc.py", "Python", 5, 0, 0, 0, 0, 0, 2, 7
"/Users/minhtranquang/Documents/entobel_proj/SFM_BackEnd/app/application/interfaces/use_cases/growing/update_status_growing_report_uc.py", "Python", 13, 0, 0, 0, 0, 0, 3, 16
"/Users/minhtranquang/Documents/entobel_proj/SFM_BackEnd/app/application/interfaces/use_cases/harvesting/create_harvesting_report_uc.py", "Python", 11, 0, 0, 0, 0, 0, 4, 15
"/Users/minhtranquang/Documents/entobel_proj/SFM_BackEnd/app/application/interfaces/use_cases/harvesting/list_harvesting_report_uc.py", "Python", 25, 0, 0, 0, 0, 0, 7, 32
"/Users/minhtranquang/Documents/entobel_proj/SFM_BackEnd/app/application/interfaces/use_cases/level/create_level_uc.py", "Python", 6, 0, 0, 0, 0, 0, 4, 10
"/Users/minhtranquang/Documents/entobel_proj/SFM_BackEnd/app/application/interfaces/use_cases/level/list_level_uc.py", "Python", 11, 0, 0, 0, 0, 0, 4, 15
"/Users/minhtranquang/Documents/entobel_proj/SFM_BackEnd/app/application/interfaces/use_cases/level/update_status_level_uc.py", "Python", 6, 0, 0, 0, 0, 0, 4, 10
"/Users/minhtranquang/Documents/entobel_proj/SFM_BackEnd/app/application/interfaces/use_cases/operation_type/create_operation_type_uc.py", "Python", 5, 0, 0, 0, 0, 0, 4, 9
"/Users/minhtranquang/Documents/entobel_proj/SFM_BackEnd/app/application/interfaces/use_cases/operation_type/list_operation_type_uc.py", "Python", 8, 0, 0, 0, 0, 0, 4, 12
"/Users/minhtranquang/Documents/entobel_proj/SFM_BackEnd/app/application/interfaces/use_cases/operation_type/update_operation_type_uc.py", "Python", 5, 0, 0, 0, 0, 0, 4, 9
"/Users/minhtranquang/Documents/entobel_proj/SFM_BackEnd/app/application/interfaces/use_cases/operation_type/update_status_operation_type_uc.py", "Python", 5, 0, 0, 0, 0, 0, 4, 9
"/Users/minhtranquang/Documents/entobel_proj/SFM_BackEnd/app/application/interfaces/use_cases/product_type/create_product_type_uc.py", "Python", 5, 0, 0, 0, 0, 0, 4, 9
"/Users/minhtranquang/Documents/entobel_proj/SFM_BackEnd/app/application/interfaces/use_cases/product_type/list_product_type_uc.py", "Python", 17, 0, 0, 0, 0, 0, 4, 21
"/Users/minhtranquang/Documents/entobel_proj/SFM_BackEnd/app/application/interfaces/use_cases/product_type/update_product_type_uc.py", "Python", 5, 0, 0, 0, 0, 0, 4, 9
"/Users/minhtranquang/Documents/entobel_proj/SFM_BackEnd/app/application/interfaces/use_cases/product_type/update_status_product_type_uc.py", "Python", 5, 0, 0, 0, 0, 0, 4, 9
"/Users/minhtranquang/Documents/entobel_proj/SFM_BackEnd/app/application/interfaces/use_cases/role/create_role_uc.py", "Python", 5, 0, 0, 0, 0, 0, 3, 8
"/Users/minhtranquang/Documents/entobel_proj/SFM_BackEnd/app/application/interfaces/use_cases/role/list_role_uc.py", "Python", 7, 0, 0, 0, 0, 0, 4, 11
"/Users/minhtranquang/Documents/entobel_proj/SFM_BackEnd/app/application/interfaces/use_cases/role/update_role_uc.py", "Python", 5, 0, 0, 0, 0, 0, 4, 9
"/Users/minhtranquang/Documents/entobel_proj/SFM_BackEnd/app/application/interfaces/use_cases/role/update_status_role_uc.py", "Python", 4, 0, 0, 0, 0, 0, 3, 7
"/Users/minhtranquang/Documents/entobel_proj/SFM_BackEnd/app/application/interfaces/use_cases/shift/create_shift_uc.py", "Python", 5, 0, 0, 0, 0, 0, 4, 9
"/Users/minhtranquang/Documents/entobel_proj/SFM_BackEnd/app/application/interfaces/use_cases/shift/list_shift_uc.py", "Python", 17, 0, 0, 0, 0, 0, 4, 21
"/Users/minhtranquang/Documents/entobel_proj/SFM_BackEnd/app/application/interfaces/use_cases/shift/update_shift_uc.py", "Python", 5, 0, 0, 0, 0, 0, 4, 9
"/Users/minhtranquang/Documents/entobel_proj/SFM_BackEnd/app/application/interfaces/use_cases/shift/update_status_shift_uc.py", "Python", 5, 0, 0, 0, 0, 0, 4, 9
"/Users/minhtranquang/Documents/entobel_proj/SFM_BackEnd/app/application/interfaces/use_cases/user/change_password_uc.py", "Python", 11, 0, 0, 0, 0, 0, 4, 15
"/Users/minhtranquang/Documents/entobel_proj/SFM_BackEnd/app/application/interfaces/use_cases/user/change_status_uc.py", "Python", 5, 0, 0, 0, 0, 0, 4, 9
"/Users/minhtranquang/Documents/entobel_proj/SFM_BackEnd/app/application/interfaces/use_cases/user/create_user_uc.py", "Python", 5, 0, 0, 0, 0, 0, 3, 8
"/Users/minhtranquang/Documents/entobel_proj/SFM_BackEnd/app/application/interfaces/use_cases/user/list_user_uc.py", "Python", 20, 0, 0, 0, 0, 0, 4, 24
"/Users/minhtranquang/Documents/entobel_proj/SFM_BackEnd/app/application/interfaces/use_cases/user/me_uc.py", "Python", 5, 0, 0, 0, 0, 0, 4, 9
"/Users/minhtranquang/Documents/entobel_proj/SFM_BackEnd/app/application/interfaces/use_cases/user/update_user_uc.py", "Python", 5, 0, 0, 0, 0, 0, 4, 9
"/Users/minhtranquang/Documents/entobel_proj/SFM_BackEnd/app/application/interfaces/use_cases/vfbd/create_vfbd_report_uc.py", "Python", 6, 0, 0, 0, 0, 0, 4, 10
"/Users/minhtranquang/Documents/entobel_proj/SFM_BackEnd/app/application/interfaces/use_cases/zone/create_zone_uc.py", "Python", 5, 0, 0, 0, 0, 0, 4, 9
"/Users/minhtranquang/Documents/entobel_proj/SFM_BackEnd/app/application/interfaces/use_cases/zone/get_specific_growing_uc.py", "Python", 5, 0, 0, 0, 0, 0, 3, 8
"/Users/minhtranquang/Documents/entobel_proj/SFM_BackEnd/app/application/interfaces/use_cases/zone/list_zone_level_uc.py", "Python", 18, 0, 0, 0, 0, 0, 3, 21
"/Users/minhtranquang/Documents/entobel_proj/SFM_BackEnd/app/application/interfaces/use_cases/zone/list_zone_uc.py", "Python", 13, 0, 0, 0, 0, 0, 4, 17
"/Users/minhtranquang/Documents/entobel_proj/SFM_BackEnd/app/application/interfaces/use_cases/zone/update_status_zone_level_uc.py", "Python", 6, 0, 0, 0, 0, 0, 4, 10
"/Users/minhtranquang/Documents/entobel_proj/SFM_BackEnd/app/application/interfaces/use_cases/zone/update_status_zone_uc.py", "Python", 5, 0, 0, 0, 0, 0, 4, 9
"/Users/minhtranquang/Documents/entobel_proj/SFM_BackEnd/app/application/interfaces/use_cases/zone/update_zone_uc.py", "Python", 5, 0, 0, 0, 0, 0, 4, 9
"/Users/minhtranquang/Documents/entobel_proj/SFM_BackEnd/app/application/use_cases/auth/__init__.py", "Python", 0, 0, 0, 0, 0, 0, 1, 1
"/Users/minhtranquang/Documents/entobel_proj/SFM_BackEnd/app/application/use_cases/auth/login_uc_impl.py", "Python", 28, 0, 0, 0, 0, 2, 8, 38
"/Users/minhtranquang/Documents/entobel_proj/SFM_BackEnd/app/application/use_cases/dd/create_dd_report_uc_impl.py", "Python", 77, 0, 0, 0, 0, 0, 16, 93
"/Users/minhtranquang/Documents/entobel_proj/SFM_BackEnd/app/application/use_cases/department/create_department_factory_role_uc_impl.py", "Python", 55, 0, 0, 0, 0, 3, 13, 71
"/Users/minhtranquang/Documents/entobel_proj/SFM_BackEnd/app/application/use_cases/department/create_department_factory_uc_impl.py", "Python", 57, 0, 0, 0, 0, 0, 14, 71
"/Users/minhtranquang/Documents/entobel_proj/SFM_BackEnd/app/application/use_cases/department/create_department_uc_impl.py", "Python", 30, 0, 0, 0, 0, 0, 9, 39
"/Users/minhtranquang/Documents/entobel_proj/SFM_BackEnd/app/application/use_cases/department/list_department_factory_role_uc_impl.py", "Python", 32, 0, 0, 0, 0, 0, 4, 36
"/Users/minhtranquang/Documents/entobel_proj/SFM_BackEnd/app/application/use_cases/department/list_department_factory_uc_impl.py", "Python", 19, 0, 0, 0, 0, 0, 4, 23
"/Users/minhtranquang/Documents/entobel_proj/SFM_BackEnd/app/application/use_cases/department/list_department_uc_impl.py", "Python", 20, 0, 0, 0, 0, 0, 4, 24
"/Users/minhtranquang/Documents/entobel_proj/SFM_BackEnd/app/application/use_cases/department/update_department_uc_impl.py", "Python", 31, 0, 0, 0, 0, 0, 14, 45
"/Users/minhtranquang/Documents/entobel_proj/SFM_BackEnd/app/application/use_cases/department/update_status_department_factory_role_uc_impl.py", "Python", 42, 0, 0, 0, 0, 0, 13, 55
"/Users/minhtranquang/Documents/entobel_proj/SFM_BackEnd/app/application/use_cases/department/update_status_department_factory_uc_impl.py", "Python", 34, 0, 0, 0, 0, 0, 12, 46
"/Users/minhtranquang/Documents/entobel_proj/SFM_BackEnd/app/application/use_cases/department/update_status_department_uc_impl.py", "Python", 29, 0, 0, 0, 0, 0, 12, 41
"/Users/minhtranquang/Documents/entobel_proj/SFM_BackEnd/app/application/use_cases/diet/create_diet_uc_impl.py", "Python", 17, 0, 0, 0, 0, 0, 9, 26
"/Users/minhtranquang/Documents/entobel_proj/SFM_BackEnd/app/application/use_cases/diet/list_diet_uc_impl.py", "Python", 21, 0, 0, 0, 0, 0, 4, 25
"/Users/minhtranquang/Documents/entobel_proj/SFM_BackEnd/app/application/use_cases/diet/update_diet_uc_impl.py", "Python", 19, 0, 0, 0, 0, 0, 10, 29
"/Users/minhtranquang/Documents/entobel_proj/SFM_BackEnd/app/application/use_cases/diet/update_status_diet_uc_impl.py", "Python", 16, 0, 0, 0, 0, 0, 8, 24
"/Users/minhtranquang/Documents/entobel_proj/SFM_BackEnd/app/application/use_cases/factory/create_factory_uc_impl.py", "Python", 19, 0, 0, 0, 0, 0, 8, 27
"/Users/minhtranquang/Documents/entobel_proj/SFM_BackEnd/app/application/use_cases/factory/list_factory_uc_impl.py", "Python", 20, 0, 0, 0, 0, 0, 4, 24
"/Users/minhtranquang/Documents/entobel_proj/SFM_BackEnd/app/application/use_cases/factory/update_factory_uc_impl.py", "Python", 39, 0, 0, 0, 0, 0, 13, 52
"/Users/minhtranquang/Documents/entobel_proj/SFM_BackEnd/app/application/use_cases/factory/update_status_factory_uc_impl.py", "Python", 31, 0, 0, 0, 0, 0, 12, 43
"/Users/minhtranquang/Documents/entobel_proj/SFM_BackEnd/app/application/use_cases/grinding/create_grinding_uc_impl.py", "Python", 64, 0, 0, 0, 0, 1, 16, 81
"/Users/minhtranquang/Documents/entobel_proj/SFM_BackEnd/app/application/use_cases/growing/create_growing_report_uc_impl.py", "Python", 128, 0, 0, 0, 0, 3, 27, 158
"/Users/minhtranquang/Documents/entobel_proj/SFM_BackEnd/app/application/use_cases/growing/get_specific_growing_uc_impl.py", "Python", 21, 0, 0, 0, 0, 0, 8, 29
"/Users/minhtranquang/Documents/entobel_proj/SFM_BackEnd/app/application/use_cases/growing/list_growing_report_uc_impl.py", "Python", 39, 0, 0, 0, 0, 0, 5, 44
"/Users/minhtranquang/Documents/entobel_proj/SFM_BackEnd/app/application/use_cases/growing/update_growing_report_uc_impl.py", "Python", 79, 0, 0, 0, 0, 0, 8, 87
"/Users/minhtranquang/Documents/entobel_proj/SFM_BackEnd/app/application/use_cases/growing/update_status_growing_report_uc_imply.py", "Python", 66, 0, 0, 0, 0, 7, 13, 86
"/Users/minhtranquang/Documents/entobel_proj/SFM_BackEnd/app/application/use_cases/harvesting/create_harvesting_report_uc_impl.py", "Python", 98, 0, 0, 0, 0, 2, 22, 122
"/Users/minhtranquang/Documents/entobel_proj/SFM_BackEnd/app/application/use_cases/harvesting/list_harvesting_report_uc_impl.py", "Python", 26, 0, 0, 0, 0, 0, 4, 30
"/Users/minhtranquang/Documents/entobel_proj/SFM_BackEnd/app/application/use_cases/level/create_level_uc_impl.py", "Python", 19, 0, 0, 0, 0, 0, 9, 28
"/Users/minhtranquang/Documents/entobel_proj/SFM_BackEnd/app/application/use_cases/level/list_level_uc_impl.py", "Python", 14, 0, 0, 0, 0, 0, 4, 18
"/Users/minhtranquang/Documents/entobel_proj/SFM_BackEnd/app/application/use_cases/level/update_status_level_uc_impl.py", "Python", 30, 0, 0, 0, 0, 1, 13, 44
"/Users/minhtranquang/Documents/entobel_proj/SFM_BackEnd/app/application/use_cases/operation_type/create_operation_type_uc_impl.py", "Python", 22, 0, 0, 0, 0, 0, 9, 31
"/Users/minhtranquang/Documents/entobel_proj/SFM_BackEnd/app/application/use_cases/operation_type/list_operation_type_uc_impl.py", "Python", 22, 0, 0, 0, 0, 0, 4, 26
"/Users/minhtranquang/Documents/entobel_proj/SFM_BackEnd/app/application/use_cases/operation_type/update_operation_type_uc_impl.py", "Python", 40, 0, 0, 0, 0, 0, 13, 53
"/Users/minhtranquang/Documents/entobel_proj/SFM_BackEnd/app/application/use_cases/operation_type/update_status_operation_type_uc_impl.py", "Python", 30, 0, 0, 0, 0, 0, 11, 41
"/Users/minhtranquang/Documents/entobel_proj/SFM_BackEnd/app/application/use_cases/product_type/create_product_type_uc_impl.py", "Python", 26, 0, 0, 0, 0, 0, 9, 35
"/Users/minhtranquang/Documents/entobel_proj/SFM_BackEnd/app/application/use_cases/product_type/list_product_type_uc_impl.py", "Python", 18, 0, 0, 0, 0, 0, 4, 22
"/Users/minhtranquang/Documents/entobel_proj/SFM_BackEnd/app/application/use_cases/product_type/update_product_type_uc_impl.py", "Python", 32, 0, 0, 0, 0, 0, 11, 43
"/Users/minhtranquang/Documents/entobel_proj/SFM_BackEnd/app/application/use_cases/product_type/update_status_product_type_uc_impl.py", "Python", 30, 0, 0, 0, 0, 0, 11, 41
"/Users/minhtranquang/Documents/entobel_proj/SFM_BackEnd/app/application/use_cases/role/create_role_uc_impl.py", "Python", 21, 0, 0, 0, 0, 0, 8, 29
"/Users/minhtranquang/Documents/entobel_proj/SFM_BackEnd/app/application/use_cases/role/list_role_uc_impl.py", "Python", 18, 0, 0, 0, 0, 0, 4, 22
"/Users/minhtranquang/Documents/entobel_proj/SFM_BackEnd/app/application/use_cases/role/update_role_status_uc_impl.py", "Python", 28, 0, 0, 0, 0, 0, 12, 40
"/Users/minhtranquang/Documents/entobel_proj/SFM_BackEnd/app/application/use_cases/role/update_role_uc_impl.py", "Python", 28, 0, 0, 0, 0, 0, 9, 37
"/Users/minhtranquang/Documents/entobel_proj/SFM_BackEnd/app/application/use_cases/shift/__init__.py", "Python", 0, 0, 0, 0, 0, 0, 1, 1
"/Users/minhtranquang/Documents/entobel_proj/SFM_BackEnd/app/application/use_cases/shift/create_shift_uc_impl.py", "Python", 20, 0, 0, 0, 0, 0, 8, 28
"/Users/minhtranquang/Documents/entobel_proj/SFM_BackEnd/app/application/use_cases/shift/list_shift_uc_impl.py", "Python", 20, 0, 0, 0, 0, 0, 4, 24
"/Users/minhtranquang/Documents/entobel_proj/SFM_BackEnd/app/application/use_cases/shift/update_shift_uc_impl.py", "Python", 31, 0, 0, 0, 0, 0, 12, 43
"/Users/minhtranquang/Documents/entobel_proj/SFM_BackEnd/app/application/use_cases/shift/update_status_shift_uc_imply.py", "Python", 21, 0, 0, 0, 0, 0, 10, 31
"/Users/minhtranquang/Documents/entobel_proj/SFM_BackEnd/app/application/use_cases/user/__init__.py", "Python", 0, 0, 0, 0, 0, 0, 1, 1
"/Users/minhtranquang/Documents/entobel_proj/SFM_BackEnd/app/application/use_cases/user/change_password_uc_impl.py", "Python", 41, 0, 0, 0, 0, 5, 10, 56
"/Users/minhtranquang/Documents/entobel_proj/SFM_BackEnd/app/application/use_cases/user/change_status_uc_impl.py", "Python", 9, 0, 0, 0, 0, 0, 4, 13
"/Users/minhtranquang/Documents/entobel_proj/SFM_BackEnd/app/application/use_cases/user/create_user_uc_impl.py", "Python", 49, 0, 0, 0, 0, 0, 11, 60
"/Users/minhtranquang/Documents/entobel_proj/SFM_BackEnd/app/application/use_cases/user/list_user_uc_impl.py", "Python", 25, 0, 0, 0, 0, 0, 4, 29
"/Users/minhtranquang/Documents/entobel_proj/SFM_BackEnd/app/application/use_cases/user/me_uc_impl.py", "Python", 25, 0, 0, 0, 0, 0, 7, 32
"/Users/minhtranquang/Documents/entobel_proj/SFM_BackEnd/app/application/use_cases/user/update_user_uc_imply.py", "Python", 23, 0, 0, 0, 0, 0, 11, 34
"/Users/minhtranquang/Documents/entobel_proj/SFM_BackEnd/app/application/use_cases/vfbd/create_vfbd_report_uc_impl.py", "Python", 78, 0, 0, 0, 0, 0, 16, 94
"/Users/minhtranquang/Documents/entobel_proj/SFM_BackEnd/app/application/use_cases/zone/create_zone_uc_impl.py", "Python", 18, 0, 0, 0, 0, 1, 9, 28
"/Users/minhtranquang/Documents/entobel_proj/SFM_BackEnd/app/application/use_cases/zone/list_zone_level_uc_impl.py", "Python", 24, 0, 0, 0, 0, 0, 4, 28
"/Users/minhtranquang/Documents/entobel_proj/SFM_BackEnd/app/application/use_cases/zone/list_zone_uc_impl.py", "Python", 22, 0, 0, 0, 0, 0, 4, 26
"/Users/minhtranquang/Documents/entobel_proj/SFM_BackEnd/app/application/use_cases/zone/update_status_zone_level_uc_impl.py", "Python", 27, 0, 0, 0, 0, 1, 11, 39
"/Users/minhtranquang/Documents/entobel_proj/SFM_BackEnd/app/application/use_cases/zone/update_status_zone_uc_impl.py", "Python", 24, 0, 0, 0, 0, 0, 11, 35
"/Users/minhtranquang/Documents/entobel_proj/SFM_BackEnd/app/application/use_cases/zone/update_zone_uc_impl.py", "Python", 25, 0, 0, 0, 0, 2, 12, 39
"/Users/minhtranquang/Documents/entobel_proj/SFM_BackEnd/app/core/config.py", "Python", 85, 0, 0, 0, 0, 14, 25, 124
"/Users/minhtranquang/Documents/entobel_proj/SFM_BackEnd/app/core/constants/common_enums.py", "Python", 17, 0, 0, 0, 0, 0, 10, 27
"/Users/minhtranquang/Documents/entobel_proj/SFM_BackEnd/app/core/database.py", "Python", 68, 0, 0, 0, 0, 1, 11, 80
"/Users/minhtranquang/Documents/entobel_proj/SFM_BackEnd/app/core/error.py", "Python", 89, 0, 0, 0, 0, 15, 24, 128
"/Users/minhtranquang/Documents/entobel_proj/SFM_BackEnd/app/core/exception.py", "Python", 77, 0, 0, 0, 0, 11, 26, 114
"/Users/minhtranquang/Documents/entobel_proj/SFM_BackEnd/app/core/security.py", "Python", 37, 0, 0, 0, 0, 0, 19, 56
"/Users/minhtranquang/Documents/entobel_proj/SFM_BackEnd/app/domain/entities/antioxidiant_type_entity.py", "Python", 17, 0, 0, 0, 0, 0, 6, 23
"/Users/minhtranquang/Documents/entobel_proj/SFM_BackEnd/app/domain/entities/dd_entity.py", "Python", 73, 0, 0, 0, 0, 3, 22, 98
"/Users/minhtranquang/Documents/entobel_proj/SFM_BackEnd/app/domain/entities/department_entity.py", "Python", 33, 0, 0, 0, 0, 0, 10, 43
"/Users/minhtranquang/Documents/entobel_proj/SFM_BackEnd/app/domain/entities/department_factory_entity.py", "Python", 20, 0, 0, 0, 0, 0, 6, 26
"/Users/minhtranquang/Documents/entobel_proj/SFM_BackEnd/app/domain/entities/department_factory_role_entity.py", "Python", 34, 0, 0, 0, 0, 0, 6, 40
"/Users/minhtranquang/Documents/entobel_proj/SFM_BackEnd/app/domain/entities/diet_entity.py", "Python", 22, 0, 0, 0, 0, 0, 7, 29
"/Users/minhtranquang/Documents/entobel_proj/SFM_BackEnd/app/domain/entities/dried_larvae_discharge_type_entity.py", "Python", 13, 0, 0, 0, 0, 0, 5, 18
"/Users/minhtranquang/Documents/entobel_proj/SFM_BackEnd/app/domain/entities/dryer_machine_type_entity.py", "Python", 20, 0, 0, 0, 0, 0, 7, 27
"/Users/minhtranquang/Documents/entobel_proj/SFM_BackEnd/app/domain/entities/factory_entity.py", "Python", 30, 0, 0, 0, 0, 0, 9, 39
"/Users/minhtranquang/Documents/entobel_proj/SFM_BackEnd/app/domain/entities/grinding_entity.py", "Python", 47, 0, 0, 0, 0, 3, 14, 64
"/Users/minhtranquang/Documents/entobel_proj/SFM_BackEnd/app/domain/entities/growing_entity.py", "Python", 67, 0, 0, 0, 0, 3, 22, 92
"/Users/minhtranquang/Documents/entobel_proj/SFM_BackEnd/app/domain/entities/growing_zone_level_entity.py", "Python", 15, 0, 0, 0, 0, 0, 3, 18
"/Users/minhtranquang/Documents/entobel_proj/SFM_BackEnd/app/domain/entities/harvesting_entity.py", "Python", 63, 0, 0, 0, 0, 3, 20, 86
"/Users/minhtranquang/Documents/entobel_proj/SFM_BackEnd/app/domain/entities/harvesting_zone_level_entity.py", "Python", 16, 0, 0, 0, 0, 0, 3, 19
"/Users/minhtranquang/Documents/entobel_proj/SFM_BackEnd/app/domain/entities/history_entity.py", "Python", 14, 0, 0, 0, 0, 0, 2, 16
"/Users/minhtranquang/Documents/entobel_proj/SFM_BackEnd/app/domain/entities/level_entity.py", "Python", 21, 0, 0, 0, 0, 0, 5, 26
"/Users/minhtranquang/Documents/entobel_proj/SFM_BackEnd/app/domain/entities/operation_type_entity.py", "Python", 26, 0, 0, 0, 0, 0, 8, 34
"/Users/minhtranquang/Documents/entobel_proj/SFM_BackEnd/app/domain/entities/packing_type_entity.py", "Python", 22, 0, 0, 0, 0, 0, 8, 30
"/Users/minhtranquang/Documents/entobel_proj/SFM_BackEnd/app/domain/entities/product_type_entity.py", "Python", 24, 0, 0, 0, 0, 0, 7, 31
"/Users/minhtranquang/Documents/entobel_proj/SFM_BackEnd/app/domain/entities/role_entity.py", "Python", 27, 0, 0, 0, 0, 0, 8, 35
"/Users/minhtranquang/Documents/entobel_proj/SFM_BackEnd/app/domain/entities/shift_entity.py", "Python", 22, 0, 0, 0, 0, 0, 7, 29
"/Users/minhtranquang/Documents/entobel_proj/SFM_BackEnd/app/domain/entities/unit_entity.py", "Python", 23, 0, 0, 0, 0, 0, 8, 31
"/Users/minhtranquang/Documents/entobel_proj/SFM_BackEnd/app/domain/entities/user_entity.py", "Python", 85, 0, 0, 0, 0, 0, 15, 100
"/Users/minhtranquang/Documents/entobel_proj/SFM_BackEnd/app/domain/entities/vfbd_entity.py", "Python", 65, 0, 0, 0, 0, 3, 19, 87
"/Users/minhtranquang/Documents/entobel_proj/SFM_BackEnd/app/domain/entities/zone_entity.py", "Python", 23, 0, 0, 0, 0, 0, 6, 29
"/Users/minhtranquang/Documents/entobel_proj/SFM_BackEnd/app/domain/entities/zone_level_entity.py", "Python", 16, 0, 0, 0, 0, 0, 4, 20
"/Users/minhtranquang/Documents/entobel_proj/SFM_BackEnd/app/domain/enums/role_enum.py", "Python", 13, 0, 0, 0, 0, 2, 5, 20
"/Users/minhtranquang/Documents/entobel_proj/SFM_BackEnd/app/domain/interfaces/repositories/common_repository.py", "Python", 5, 0, 0, 0, 0, 0, 3, 8
"/Users/minhtranquang/Documents/entobel_proj/SFM_BackEnd/app/domain/interfaces/repositories/dd_repository.py", "Python", 25, 0, 0, 0, 0, 1, 5, 31
"/Users/minhtranquang/Documents/entobel_proj/SFM_BackEnd/app/domain/interfaces/repositories/deparment_factory_role_repository.py", "Python", 41, 0, 0, 0, 0, 0, 9, 50
"/Users/minhtranquang/Documents/entobel_proj/SFM_BackEnd/app/domain/interfaces/repositories/department_factory_repository.py", "Python", 40, 0, 0, 0, 0, 1, 9, 50
"/Users/minhtranquang/Documents/entobel_proj/SFM_BackEnd/app/domain/interfaces/repositories/department_repository.py", "Python", 20, 0, 0, 0, 0, 0, 10, 30
"/Users/minhtranquang/Documents/entobel_proj/SFM_BackEnd/app/domain/interfaces/repositories/diet_repository.py", "Python", 27, 0, 0, 0, 0, 0, 9, 36
"/Users/minhtranquang/Documents/entobel_proj/SFM_BackEnd/app/domain/interfaces/repositories/factory_repository.py", "Python", 20, 0, 0, 0, 0, 0, 9, 29
"/Users/minhtranquang/Documents/entobel_proj/SFM_BackEnd/app/domain/interfaces/repositories/grinding_repository.py", "Python", 38, 0, 0, 0, 0, 0, 9, 47
"/Users/minhtranquang/Documents/entobel_proj/SFM_BackEnd/app/domain/interfaces/repositories/growing_repository.py", "Python", 51, 0, 0, 0, 0, 0, 7, 58
"/Users/minhtranquang/Documents/entobel_proj/SFM_BackEnd/app/domain/interfaces/repositories/harvesting_repository.py", "Python", 29, 0, 0, 0, 0, 0, 5, 34
"/Users/minhtranquang/Documents/entobel_proj/SFM_BackEnd/app/domain/interfaces/repositories/level_repository.py", "Python", 25, 0, 0, 0, 0, 0, 10, 35
"/Users/minhtranquang/Documents/entobel_proj/SFM_BackEnd/app/domain/interfaces/repositories/operation_type_repository.py", "Python", 36, 0, 0, 0, 0, 0, 9, 45
"/Users/minhtranquang/Documents/entobel_proj/SFM_BackEnd/app/domain/interfaces/repositories/packing_type_repository.py", "Python", 11, 0, 0, 0, 0, 0, 4, 15
"/Users/minhtranquang/Documents/entobel_proj/SFM_BackEnd/app/domain/interfaces/repositories/product_type_repository.py", "Python", 25, 0, 0, 0, 0, 0, 9, 34
"/Users/minhtranquang/Documents/entobel_proj/SFM_BackEnd/app/domain/interfaces/repositories/role_repository.py", "Python", 23, 0, 0, 0, 0, 0, 10, 33
"/Users/minhtranquang/Documents/entobel_proj/SFM_BackEnd/app/domain/interfaces/repositories/shift_repository.py", "Python", 13, 0, 0, 0, 0, 0, 8, 21
"/Users/minhtranquang/Documents/entobel_proj/SFM_BackEnd/app/domain/interfaces/repositories/user_repository.py", "Python", 39, 0, 0, 0, 0, 0, 12, 51
"/Users/minhtranquang/Documents/entobel_proj/SFM_BackEnd/app/domain/interfaces/repositories/vfbd_repository.py", "Python", 5, 0, 0, 0, 0, 0, 4, 9
"/Users/minhtranquang/Documents/entobel_proj/SFM_BackEnd/app/domain/interfaces/repositories/zone_level_repository.py", "Python", 0, 0, 0, 0, 0, 0, 1, 1
"/Users/minhtranquang/Documents/entobel_proj/SFM_BackEnd/app/domain/interfaces/repositories/zone_repository.py", "Python", 51, 0, 0, 0, 0, 0, 15, 66
"/Users/minhtranquang/Documents/entobel_proj/SFM_BackEnd/app/domain/interfaces/services/access_policy_service.py", "Python", 24, 0, 0, 0, 0, 0, 10, 34
"/Users/minhtranquang/Documents/entobel_proj/SFM_BackEnd/app/domain/interfaces/services/cursor_query_helper.py", "Python", 19, 0, 0, 0, 0, 0, 9, 28
"/Users/minhtranquang/Documents/entobel_proj/SFM_BackEnd/app/domain/interfaces/services/password_service.py", "Python", 6, 0, 0, 0, 0, 0, 5, 11
"/Users/minhtranquang/Documents/entobel_proj/SFM_BackEnd/app/domain/interfaces/services/query_helper_service.py", "Python", 43, 0, 0, 0, 0, 0, 16, 59
"/Users/minhtranquang/Documents/entobel_proj/SFM_BackEnd/app/domain/interfaces/services/token_service.py", "Python", 7, 0, 0, 0, 0, 0, 5, 12
"/Users/minhtranquang/Documents/entobel_proj/SFM_BackEnd/app/domain/services/__init__.py", "Python", 0, 0, 0, 0, 0, 0, 2, 2
"/Users/minhtranquang/Documents/entobel_proj/SFM_BackEnd/app/domain/services/auth_service.py", "Python", 36, 0, 0, 0, 0, 3, 16, 55
"/Users/minhtranquang/Documents/entobel_proj/SFM_BackEnd/app/domain/services/role_service.py", "Python", 0, 0, 0, 0, 0, 0, 1, 1
"/Users/minhtranquang/Documents/entobel_proj/SFM_BackEnd/app/domain/value_objects/access_policy.py", "Python", 9, 0, 0, 0, 0, 0, 3, 12
"/Users/minhtranquang/Documents/entobel_proj/SFM_BackEnd/app/domain/value_objects/token_payload.py", "Python", 19, 0, 0, 0, 0, 1, 5, 25
"/Users/minhtranquang/Documents/entobel_proj/SFM_BackEnd/app/infrastructure/database/repositories/common_repository_impl.py", "Python", 11, 0, 0, 0, 0, 0, 7, 18
"/Users/minhtranquang/Documents/entobel_proj/SFM_BackEnd/app/infrastructure/database/repositories/dd_repository_impl.py", "Python", 120, 0, 0, 0, 0, 12, 13, 145
"/Users/minhtranquang/Documents/entobel_proj/SFM_BackEnd/app/infrastructure/database/repositories/department_factory_repository_impl.py", "Python", 123, 0, 0, 0, 0, 116, 19, 258
"/Users/minhtranquang/Documents/entobel_proj/SFM_BackEnd/app/infrastructure/database/repositories/department_factory_role_repository_impl.py", "Python", 175, 0, 0, 0, 0, 24, 15, 214
"/Users/minhtranquang/Documents/entobel_proj/SFM_BackEnd/app/infrastructure/database/repositories/department_repository_impl.py", "Python", 77, 0, 0, 0, 0, 75, 9, 161
"/Users/minhtranquang/Documents/entobel_proj/SFM_BackEnd/app/infrastructure/database/repositories/diet_repository_impl.py", "Python", 56, 0, 0, 0, 0, 73, 14, 143
"/Users/minhtranquang/Documents/entobel_proj/SFM_BackEnd/app/infrastructure/database/repositories/factory_repository_impl.py", "Python", 62, 0, 0, 0, 0, 86, 10, 158
"/Users/minhtranquang/Documents/entobel_proj/SFM_BackEnd/app/infrastructure/database/repositories/grinding_repository_impl.py", "Python", 179, 0, 0, 0, 0, 0, 17, 196
"/Users/minhtranquang/Documents/entobel_proj/SFM_BackEnd/app/infrastructure/database/repositories/growing_repository_impl.py", "Python", 474, 0, 0, 0, 0, 300, 65, 839
"/Users/minhtranquang/Documents/entobel_proj/SFM_BackEnd/app/infrastructure/database/repositories/harvesting_repository_impl.py", "Python", 173, 0, 0, 0, 0, 118, 19, 310
"/Users/minhtranquang/Documents/entobel_proj/SFM_BackEnd/app/infrastructure/database/repositories/level_repository_impl.py", "Python", 62, 0, 0, 0, 0, 98, 11, 171
"/Users/minhtranquang/Documents/entobel_proj/SFM_BackEnd/app/infrastructure/database/repositories/operation_type_repository_impl.py", "Python", 53, 0, 0, 0, 0, 84, 12, 149
"/Users/minhtranquang/Documents/entobel_proj/SFM_BackEnd/app/infrastructure/database/repositories/product_type_repository_impl.py", "Python", 43, 0, 0, 0, 0, 95, 7, 145
"/Users/minhtranquang/Documents/entobel_proj/SFM_BackEnd/app/infrastructure/database/repositories/role_repository_impl.py", "Python", 125, 0, 0, 0, 0, 9, 9, 143
"/Users/minhtranquang/Documents/entobel_proj/SFM_BackEnd/app/infrastructure/database/repositories/shift_repository_impl.py", "Python", 77, 0, 0, 0, 0, 29, 21, 127
"/Users/minhtranquang/Documents/entobel_proj/SFM_BackEnd/app/infrastructure/database/repositories/user_repository_impl.py", "Python", 325, 0, 0, 0, 0, 117, 27, 469
"/Users/minhtranquang/Documents/entobel_proj/SFM_BackEnd/app/infrastructure/database/repositories/vfbd_repository_impl.py", "Python", 75, 0, 0, 0, 0, 0, 7, 82
"/Users/minhtranquang/Documents/entobel_proj/SFM_BackEnd/app/infrastructure/database/repositories/zone_repository_impl.py", "Python", 164, 0, 0, 0, 0, 247, 12, 423
"/Users/minhtranquang/Documents/entobel_proj/SFM_BackEnd/app/infrastructure/services/access_policy_service_impl.py", "Python", 70, 0, 0, 0, 0, 26, 21, 117
"/Users/minhtranquang/Documents/entobel_proj/SFM_BackEnd/app/infrastructure/services/cursor_query_helper_service_impl.py", "Python", 32, 0, 0, 0, 0, 0, 11, 43
"/Users/minhtranquang/Documents/entobel_proj/SFM_BackEnd/app/infrastructure/services/password_service_imply.py", "Python", 8, 0, 0, 0, 0, 0, 5, 13
"/Users/minhtranquang/Documents/entobel_proj/SFM_BackEnd/app/infrastructure/services/query_helper_service_impl.py", "Python", 80, 0, 0, 0, 0, 4, 23, 107
"/Users/minhtranquang/Documents/entobel_proj/SFM_BackEnd/app/infrastructure/services/token_service_imply.py", "Python", 10, 0, 0, 0, 0, 0, 5, 15
"/Users/minhtranquang/Documents/entobel_proj/SFM_BackEnd/app/main.py", "Python", 75, 0, 0, 0, 0, 8, 15, 98
"/Users/minhtranquang/Documents/entobel_proj/SFM_BackEnd/app/presentation/__init__.py", "Python", 0, 0, 0, 0, 0, 0, 1, 1
"/Users/minhtranquang/Documents/entobel_proj/SFM_BackEnd/app/presentation/api/__init__.py", "Python", 0, 0, 0, 0, 0, 0, 1, 1
"/Users/minhtranquang/Documents/entobel_proj/SFM_BackEnd/app/presentation/api/v1/dependencies/__init__.py", "Python", 0, 0, 0, 0, 0, 0, 1, 1
"/Users/minhtranquang/Documents/entobel_proj/SFM_BackEnd/app/presentation/api/v1/dependencies/auth_dependencies.py", "Python", 25, 0, 0, 0, 0, 0, 11, 36
"/Users/minhtranquang/Documents/entobel_proj/SFM_BackEnd/app/presentation/api/v1/dependencies/common_dependencies.py", "Python", 37, 0, 0, 0, 0, 0, 22, 59
"/Users/minhtranquang/Documents/entobel_proj/SFM_BackEnd/app/presentation/api/v1/dependencies/dd_dependencies.py", "Python", 14, 0, 0, 0, 0, 0, 10, 24
"/Users/minhtranquang/Documents/entobel_proj/SFM_BackEnd/app/presentation/api/v1/dependencies/department_dependencies.py", "Python", 208, 0, 0, 0, 0, 0, 42, 250
"/Users/minhtranquang/Documents/entobel_proj/SFM_BackEnd/app/presentation/api/v1/dependencies/diet_dependencies.py", "Python", 45, 0, 0, 0, 0, 0, 17, 62
"/Users/minhtranquang/Documents/entobel_proj/SFM_BackEnd/app/presentation/api/v1/dependencies/factory_dependencies.py", "Python", 55, 0, 0, 0, 0, 0, 17, 72
"/Users/minhtranquang/Documents/entobel_proj/SFM_BackEnd/app/presentation/api/v1/dependencies/grinding_dependencies.py", "Python", 21, 0, 0, 0, 0, 0, 10, 31
"/Users/minhtranquang/Documents/entobel_proj/SFM_BackEnd/app/presentation/api/v1/dependencies/growing_dependencies.py", "Python", 75, 0, 0, 0, 0, 0, 14, 89
"/Users/minhtranquang/Documents/entobel_proj/SFM_BackEnd/app/presentation/api/v1/dependencies/harvesting_dependencies.py", "Python", 38, 0, 0, 0, 0, 0, 13, 51
"/Users/minhtranquang/Documents/entobel_proj/SFM_BackEnd/app/presentation/api/v1/dependencies/level_dependencies.py", "Python", 23, 0, 0, 0, 0, 0, 15, 38
"/Users/minhtranquang/Documents/entobel_proj/SFM_BackEnd/app/presentation/api/v1/dependencies/operation_type_denpendencies.py", "Python", 70, 0, 0, 0, 0, 0, 17, 87
"/Users/minhtranquang/Documents/entobel_proj/SFM_BackEnd/app/presentation/api/v1/dependencies/product_type_dependencies.py", "Python", 69, 0, 0, 0, 0, 0, 17, 86
"/Users/minhtranquang/Documents/entobel_proj/SFM_BackEnd/app/presentation/api/v1/dependencies/role_dependencies.py", "Python", 43, 0, 0, 0, 0, 0, 15, 58
"/Users/minhtranquang/Documents/entobel_proj/SFM_BackEnd/app/presentation/api/v1/dependencies/shift_dependencies.py", "Python", 49, 0, 0, 0, 0, 0, 17, 66
"/Users/minhtranquang/Documents/entobel_proj/SFM_BackEnd/app/presentation/api/v1/dependencies/user_dependencies.py", "Python", 91, 0, 0, 0, 0, 2, 30, 123
"/Users/minhtranquang/Documents/entobel_proj/SFM_BackEnd/app/presentation/api/v1/dependencies/vfbd_dependencies.py", "Python", 14, 0, 0, 0, 0, 0, 10, 24
"/Users/minhtranquang/Documents/entobel_proj/SFM_BackEnd/app/presentation/api/v1/dependencies/zone_dependencies.py", "Python", 78, 0, 0, 0, 0, 0, 23, 101
"/Users/minhtranquang/Documents/entobel_proj/SFM_BackEnd/app/presentation/api/v1/endpoints/__init__.py", "Python", 0, 0, 0, 0, 0, 0, 1, 1
"/Users/minhtranquang/Documents/entobel_proj/SFM_BackEnd/app/presentation/api/v1/endpoints/auth_endpoints.py", "Python", 33, 0, 0, 0, 0, 0, 8, 41
"/Users/minhtranquang/Documents/entobel_proj/SFM_BackEnd/app/presentation/api/v1/endpoints/dd_endpoints.py", "Python", 47, 0, 0, 0, 0, 0, 8, 55
"/Users/minhtranquang/Documents/entobel_proj/SFM_BackEnd/app/presentation/api/v1/endpoints/department_endpoints.py", "Python", 269, 0, 0, 0, 0, 1, 50, 320
"/Users/minhtranquang/Documents/entobel_proj/SFM_BackEnd/app/presentation/api/v1/endpoints/diet_endpoints.py", "Python", 87, 0, 0, 0, 0, 3, 21, 111
"/Users/minhtranquang/Documents/entobel_proj/SFM_BackEnd/app/presentation/api/v1/endpoints/factory_endpoints.py", "Python", 95, 0, 0, 0, 0, 0, 20, 115
"/Users/minhtranquang/Documents/entobel_proj/SFM_BackEnd/app/presentation/api/v1/endpoints/grinding_endpoints.py", "Python", 39, 0, 0, 0, 0, 2, 9, 50
"/Users/minhtranquang/Documents/entobel_proj/SFM_BackEnd/app/presentation/api/v1/endpoints/growing_endpoints.py", "Python", 234, 0, 0, 0, 0, 0, 30, 264
"/Users/minhtranquang/Documents/entobel_proj/SFM_BackEnd/app/presentation/api/v1/endpoints/harvesting_endpoints.py", "Python", 149, 0, 0, 0, 0, 0, 20, 169
"/Users/minhtranquang/Documents/entobel_proj/SFM_BackEnd/app/presentation/api/v1/endpoints/level_endpoints.py", "Python", 70, 0, 0, 0, 0, 1, 18, 89
"/Users/minhtranquang/Documents/entobel_proj/SFM_BackEnd/app/presentation/api/v1/endpoints/operation_type_endpoints.py", "Python", 96, 0, 0, 0, 0, 4, 22, 122
"/Users/minhtranquang/Documents/entobel_proj/SFM_BackEnd/app/presentation/api/v1/endpoints/product_type_endpoints.py", "Python", 100, 0, 0, 0, 0, 1, 21, 122
"/Users/minhtranquang/Documents/entobel_proj/SFM_BackEnd/app/presentation/api/v1/endpoints/role_endpoints.py", "Python", 79, 0, 0, 0, 0, 0, 19, 98
"/Users/minhtranquang/Documents/entobel_proj/SFM_BackEnd/app/presentation/api/v1/endpoints/shift_endpoints.py", "Python", 91, 0, 0, 0, 0, 0, 22, 113
"/Users/minhtranquang/Documents/entobel_proj/SFM_BackEnd/app/presentation/api/v1/endpoints/user_endpoints.py", "Python", 161, 0, 0, 0, 0, 2, 26, 189
"/Users/minhtranquang/Documents/entobel_proj/SFM_BackEnd/app/presentation/api/v1/endpoints/vfbd_endpoints.py", "Python", 45, 0, 0, 0, 0, 0, 9, 54
"/Users/minhtranquang/Documents/entobel_proj/SFM_BackEnd/app/presentation/api/v1/endpoints/zone_endpoints.py", "Python", 166, 0, 0, 0, 0, 3, 36, 205
"/Users/minhtranquang/Documents/entobel_proj/SFM_BackEnd/app/presentation/api/v1/routes.py", "Python", 40, 0, 0, 0, 0, 0, 5, 45
"/Users/minhtranquang/Documents/entobel_proj/SFM_BackEnd/app/presentation/schemas/__init__.py", "Python", 0, 0, 0, 0, 0, 0, 1, 1
"/Users/minhtranquang/Documents/entobel_proj/SFM_BackEnd/app/presentation/schemas/auth_schema.py", "Python", 8, 0, 0, 0, 0, 0, 6, 14
"/Users/minhtranquang/Documents/entobel_proj/SFM_BackEnd/app/presentation/schemas/dd_schema.py", "Python", 57, 0, 0, 0, 0, 0, 6, 63
"/Users/minhtranquang/Documents/entobel_proj/SFM_BackEnd/app/presentation/schemas/department_factory_role_schema.py", "Python", 53, 0, 0, 0, 0, 0, 14, 67
"/Users/minhtranquang/Documents/entobel_proj/SFM_BackEnd/app/presentation/schemas/department_factory_schema.py", "Python", 46, 0, 0, 0, 0, 0, 10, 56
"/Users/minhtranquang/Documents/entobel_proj/SFM_BackEnd/app/presentation/schemas/department_schema.py", "Python", 100, 0, 0, 0, 0, 0, 23, 123
"/Users/minhtranquang/Documents/entobel_proj/SFM_BackEnd/app/presentation/schemas/diet_schema.py", "Python", 70, 0, 0, 0, 0, 0, 19, 89
"/Users/minhtranquang/Documents/entobel_proj/SFM_BackEnd/app/presentation/schemas/factory_schema.py", "Python", 120, 0, 0, 0, 0, 0, 26, 146
"/Users/minhtranquang/Documents/entobel_proj/SFM_BackEnd/app/presentation/schemas/filter_schema.py", "Python", 54, 0, 0, 0, 0, 4, 9, 67
"/Users/minhtranquang/Documents/entobel_proj/SFM_BackEnd/app/presentation/schemas/grinding_schema.py", "Python", 39, 0, 0, 0, 0, 0, 6, 45
"/Users/minhtranquang/Documents/entobel_proj/SFM_BackEnd/app/presentation/schemas/growing_schema.py", "Python", 184, 0, 0, 0, 0, 4, 27, 215
"/Users/minhtranquang/Documents/entobel_proj/SFM_BackEnd/app/presentation/schemas/growing_zone_level_schema.py", "Python", 13, 0, 0, 0, 0, 0, 5, 18
"/Users/minhtranquang/Documents/entobel_proj/SFM_BackEnd/app/presentation/schemas/harvesting_schema.py", "Python", 70, 0, 0, 0, 0, 0, 14, 84
"/Users/minhtranquang/Documents/entobel_proj/SFM_BackEnd/app/presentation/schemas/harvesting_zone_level_schema.py", "Python", 13, 0, 0, 0, 0, 0, 5, 18
"/Users/minhtranquang/Documents/entobel_proj/SFM_BackEnd/app/presentation/schemas/level_schema.py", "Python", 53, 0, 0, 0, 0, 0, 14, 67
"/Users/minhtranquang/Documents/entobel_proj/SFM_BackEnd/app/presentation/schemas/operation_type_schema.py", "Python", 93, 0, 0, 0, 0, 0, 22, 115
"/Users/minhtranquang/Documents/entobel_proj/SFM_BackEnd/app/presentation/schemas/product_type_schema.py", "Python", 77, 0, 0, 0, 0, 0, 20, 97
"/Users/minhtranquang/Documents/entobel_proj/SFM_BackEnd/app/presentation/schemas/response.py", "Python", 34, 0, 0, 0, 0, 7, 13, 54
"/Users/minhtranquang/Documents/entobel_proj/SFM_BackEnd/app/presentation/schemas/role_schema.py", "Python", 84, 0, 0, 0, 0, 0, 23, 107
"/Users/minhtranquang/Documents/entobel_proj/SFM_BackEnd/app/presentation/schemas/shift_schema.py", "Python", 64, 0, 0, 0, 0, 0, 18, 82
"/Users/minhtranquang/Documents/entobel_proj/SFM_BackEnd/app/presentation/schemas/token_schema.py", "Python", 10, 0, 0, 0, 0, 0, 4, 14
"/Users/minhtranquang/Documents/entobel_proj/SFM_BackEnd/app/presentation/schemas/user_schema.py", "Python", 175, 0, 0, 0, 0, 0, 37, 212
"/Users/minhtranquang/Documents/entobel_proj/SFM_BackEnd/app/presentation/schemas/vfbd_schema.py", "Python", 52, 0, 0, 0, 0, 0, 6, 58
"/Users/minhtranquang/Documents/entobel_proj/SFM_BackEnd/app/presentation/schemas/zone_level_schema.py", "Python", 14, 0, 0, 0, 0, 0, 5, 19
"/Users/minhtranquang/Documents/entobel_proj/SFM_BackEnd/app/presentation/schemas/zone_schema.py", "Python", 116, 0, 0, 0, 0, 0, 29, 145
"/Users/minhtranquang/Documents/entobel_proj/SFM_BackEnd/commit-each.sh", "Shell Script", 0, 0, 7, 0, 0, 6, 5, 18
"/Users/minhtranquang/Documents/entobel_proj/SFM_BackEnd/requirements.txt", "pip requirements", 0, 50, 0, 0, 0, 0, 0, 50
"Total", "-", 11870, 50, 7, 86, 95, 1683, 2982, 16773